language,participant_id,words,minutes,wpm,types,tokens,ttr,english_types,english_tokens,english_ttr,spanish_types,spanish_tokens,spanish_ttr,disfluencies,fluency_score
eng,146,178,3.817,46.638,77,164,0.47,77,164,0.47,0,0,0.0,14,0.079
eng,136,563,6.533,86.173,164,502,0.327,164,502,0.327,0,0,0.0,61,0.108
spa,150,145,6.615,21.919,36,122,0.295,3,9,0.333,33,113,0.27,23,0.159
eng,104,413,3.738,110.475,117,357,0.328,116,356,0.326,1,1,0.003,56,0.136
spa,107,284,8.329,34.098,75,251,0.299,8,12,0.667,67,239,0.267,33,0.116
eng,111,292,3.3,88.485,89,265,0.336,89,265,0.336,0,0,0.0,27,0.092
spa,129,253,4.845,52.215,91,231,0.394,0,0,0,91,231,0.394,22,0.087
spa,135,200,3.338,59.907,78,192,0.406,0,0,0,78,192,0.406,8,0.04
spa,145,185,6.735,27.47,58,157,0.369,4,4,1.0,54,153,0.344,28,0.151
eng,153,632,8.9,71.011,190,599,0.317,190,599,0.317,0,0,0.0,33,0.052
eng,126,511,10.939,46.714,228,485,0.47,228,485,0.47,0,0,0.0,26,0.051
eng,108,155,2.633,58.861,62,145,0.428,62,145,0.428,0,0,0.0,10,0.065
spa,140,134,3.1,43.225,41,125,0.328,0,0,0,41,125,0.328,9,0.067
spa,130,235,7.459,31.506,74,190,0.389,8,8,1.0,66,182,0.347,45,0.191
spa,125,284,5.184,54.786,81,244,0.332,0,0,0,81,244,0.332,40,0.141
eng,133,329,5.117,64.3,96,280,0.343,96,280,0.343,0,0,0.0,49,0.149
eng,143,460,5.467,84.146,114,385,0.296,114,385,0.296,0,0,0.0,75,0.163
spa,139,233,4.799,48.552,91,205,0.444,1,1,1.0,90,204,0.439,28,0.12
spa,149,199,4.302,46.253,60,182,0.33,0,0,0,60,182,0.33,17,0.085
eng,130,215,4.417,48.679,63,195,0.323,63,195,0.323,0,0,0.0,20,0.093
eng,140,107,2.172,49.264,46,101,0.455,46,101,0.455,0,0,0.0,6,0.056
spa,126,242,6.374,37.967,72,207,0.348,6,6,1.0,66,201,0.319,35,0.145
spa,143,456,7.108,64.154,112,387,0.289,0,0,0,112,387,0.289,69,0.151
spa,133,195,3.275,59.546,69,182,0.379,1,1,1.0,68,181,0.374,13,0.067
eng,125,201,2.209,90.999,73,189,0.386,73,189,0.386,0,0,0.0,12,0.06
eng,139,241,3.133,76.915,93,238,0.391,93,238,0.391,0,0,0.0,3,0.012
spa,136,508,6.925,73.354,159,462,0.344,0,0,0,159,462,0.344,46,0.091
spa,146,181,7.05,25.674,74,150,0.493,2,2,1.0,72,148,0.48,31,0.171
spa,104,370,4.774,77.496,114,311,0.367,27,28,0.964,87,283,0.28,59,0.159
eng,129,249,3.343,74.489,94,240,0.392,94,240,0.392,0,0,0.0,9,0.036
spa,111,136,1.419,95.814,58,121,0.479,0,0,0,58,121,0.479,15,0.11
eng,107,336,3.684,91.202,124,327,0.379,124,327,0.379,0,0,0.0,9,0.027
eng,140,120,2.006,59.83,52,110,0.473,52,110,0.473,0,0,0.0,10,0.083
eng,145,246,3.717,66.188,103,244,0.422,103,244,0.422,0,0,0.0,2,0.008
eng,135,227,2.834,80.112,86,216,0.398,86,216,0.398,0,0,0.0,11,0.048
spa,148,406,6.238,65.084,102,338,0.302,0,0,0,102,338,0.302,68,0.167
spa,138,259,4.786,54.12,86,240,0.358,0,0,0,86,240,0.358,19,0.073
eng,142,413,8.383,49.264,71,344,0.206,50,301,0.166,19,43,0.055,69,0.167
eng,132,290,6.347,45.688,74,256,0.289,74,256,0.289,0,0,0.0,34,0.117
eng,127,227,4.25,53.412,76,203,0.374,76,203,0.374,0,0,0.0,24,0.106
spa,131,658,8.747,75.227,128,500,0.256,25,39,0.641,104,461,0.208,158,0.24
spa,141,212,4.135,51.269,84,210,0.4,0,0,0,84,210,0.4,2,0.009
eng,109,258,2.8,92.143,101,250,0.404,101,250,0.404,0,0,0.0,8,0.031
eng,115,335,4.119,81.334,75,270,0.278,75,270,0.278,0,0,0.0,65,0.194
spa,103,280,4.638,60.369,90,250,0.36,1,1,1.0,89,249,0.356,30,0.107
spa,144,296,4.265,69.41,104,271,0.384,0,0,0,104,271,0.384,25,0.084
spa,134,331,5.334,62.055,89,277,0.321,1,1,1.0,88,276,0.318,54,0.163
eng,122,315,3.938,79.994,82,269,0.305,82,269,0.305,0,0,0.0,46,0.146
spa,106,224,4.922,45.506,68,178,0.382,1,11,0.091,67,167,0.376,46,0.205
spa,128,279,6.35,43.936,77,235,0.328,0,0,0,77,235,0.328,44,0.158
eng,110,322,2.867,112.326,93,288,0.323,93,288,0.323,0,0,0.0,34,0.106
eng,105,283,3.654,77.447,91,262,0.347,91,262,0.347,0,0,0.0,21,0.074
spa,108,285,3.675,77.561,87,267,0.326,3,6,0.5,84,261,0.315,18,0.063
spa,113,200,8.202,24.383,60,145,0.414,17,29,0.586,40,116,0.276,55,0.275
eng,137,591,5.552,106.444,142,522,0.272,142,522,0.272,0,0,0.0,69,0.117
eng,147,597,5.683,105.044,189,553,0.342,189,553,0.342,0,0,0.0,44,0.074
spa,151,295,6.242,47.262,104,278,0.374,3,3,1.0,101,275,0.363,17,0.058
spa,121,397,3.99,99.496,124,369,0.336,3,3,1.0,121,366,0.328,28,0.071
spa,122,256,6.254,40.931,74,216,0.343,37,58,0.638,37,158,0.171,40,0.156
eng,144,277,3.483,79.522,95,270,0.352,95,270,0.352,0,0,0.0,7,0.025
spa,110,338,3.431,98.524,98,304,0.322,1,1,1.0,97,303,0.319,34,0.101
eng,128,363,5.567,65.21,76,282,0.27,76,282,0.27,0,0,0.0,81,0.223
eng,106,152,4.1,37.073,51,128,0.398,51,128,0.398,0,0,0.0,24,0.158
eng,113,176,4.957,35.503,69,153,0.451,69,153,0.451,0,0,0.0,23,0.131
spa,105,272,5.934,45.836,97,254,0.382,0,0,0,97,254,0.382,18,0.066
eng,122,248,3.496,70.938,108,238,0.454,108,238,0.454,0,0,0.0,10,0.04
spa,147,838,11.352,73.821,195,689,0.283,0,0,0,195,689,0.283,149,0.178
spa,137,504,9.767,51.605,112,430,0.26,2,3,0.667,110,427,0.256,74,0.147
eng,138,275,3.625,75.862,105,261,0.402,105,261,0.402,0,0,0.0,14,0.051
eng,148,589,5.2,113.269,125,493,0.254,125,493,0.254,0,0,0.0,96,0.163
spa,132,248,3.389,73.182,75,211,0.355,0,0,0,75,211,0.355,37,0.149
spa,142,388,5.954,65.17,132,370,0.357,3,3,1.0,129,367,0.349,18,0.046
eng,154,485,8.05,60.248,153,441,0.347,153,441,0.347,0,0,0.0,44,0.091
spa,109,236,2.267,104.118,81,229,0.354,8,9,0.889,73,220,0.319,7,0.03
eng,131,459,5.6,81.964,140,398,0.352,140,398,0.352,0,0,0.0,61,0.133
spa,127,269,5.073,53.029,71,227,0.313,22,39,0.564,49,188,0.216,42,0.156
eng,103,351,4.61,76.142,127,323,0.393,127,323,0.393,0,0,0.0,28,0.08
spa,115,259,4.482,57.789,73,229,0.319,1,4,0.25,72,225,0.314,30,0.116
spa,217,377,3.68,102.452,142,350,0.406,2,2,1.0,140,348,0.4,27,0.072
spa,207,266,3.45,77.091,108,257,0.42,1,1,1.0,107,256,0.416,9,0.034
eng,211,381,4.273,89.172,141,371,0.38,141,371,0.38,0,0,0.0,10,0.026
eng,218,318,3.361,94.629,105,298,0.352,105,298,0.352,0,0,0.0,20,0.063
spa,212,740,7.577,97.669,212,704,0.301,0,0,0,212,704,0.301,36,0.049
spa,211,172,3.684,46.684,59,168,0.351,1,1,1.0,58,167,0.345,4,0.023
eng,207,416,4.392,94.728,118,351,0.336,118,351,0.336,0,0,0.0,65,0.156
spa,218,385,5.766,66.772,118,359,0.329,5,6,0.833,112,353,0.312,26,0.068
eng,217,298,3.061,97.342,130,292,0.445,130,292,0.445,0,0,0.0,6,0.02
spa,219,287,3.039,94.438,115,280,0.411,0,0,0,115,280,0.411,7,0.024
spa,213,210,3.613,58.117,93,209,0.445,0,0,0,93,209,0.445,1,0.005
spa,206,285,4.001,71.235,99,265,0.374,1,3,0.333,98,262,0.37,20,0.07
eng,210,270,4.8,56.25,61,240,0.254,58,208,0.279,3,32,0.013,30,0.111
eng,213,80,1.98,40.404,36,72,0.5,36,72,0.5,0,0,0.0,8,0.1
spa,219,296,4.173,70.939,115,275,0.418,26,32,0.812,87,243,0.316,21,0.071
spa,210,236,4.916,48.004,82,229,0.358,0,0,0,82,229,0.358,7,0.03
eng,206,282,3.867,72.931,91,265,0.343,91,265,0.343,0,0,0.0,17,0.06
eng,334,239,3.571,66.928,90,224,0.402,90,224,0.402,0,0,0.0,15,0.063
eng,303,374,5.95,62.857,130,353,0.368,130,353,0.368,0,0,0.0,21,0.056
eng,341,326,4.083,79.837,118,289,0.408,118,289,0.408,0,0,0.0,37,0.113
eng,331,329,4.2,78.333,102,315,0.324,102,315,0.324,0,0,0.0,14,0.043
eng,329,218,5.397,40.395,88,214,0.411,88,214,0.411,0,0,0.0,4,0.018
eng,324,235,3.367,69.802,69,200,0.345,69,200,0.345,0,0,0.0,35,0.149
eng,316,392,5.633,69.584,138,358,0.385,138,358,0.385,0,0,0.0,34,0.087
eng,338,192,4.283,44.825,70,179,0.391,70,179,0.391,0,0,0.0,13,0.068
eng,328,197,4.424,44.526,80,197,0.406,80,197,0.406,0,0,0.0,0,0.0
eng,315,561,6.654,84.308,183,497,0.368,183,497,0.368,0,0,0.0,64,0.114
eng,332,311,4.983,62.408,132,295,0.447,132,295,0.447,0,0,0.0,16,0.051
eng,319,346,4.323,80.035,140,341,0.411,140,341,0.411,0,0,0.0,5,0.014
eng,337,435,4.733,91.901,151,421,0.359,151,421,0.359,0,0,0.0,14,0.032
eng,310,280,5.805,48.236,106,267,0.397,106,267,0.397,0,0,0.0,13,0.046
eng,322,199,4.013,49.589,90,197,0.457,90,197,0.457,0,0,0.0,2,0.01
eng,317,181,4.53,39.956,69,155,0.445,69,155,0.445,0,0,0.0,26,0.144
eng,339,324,3.317,97.688,103,292,0.353,103,292,0.353,0,0,0.0,32,0.099
eng,325,294,6.0,49.0,111,271,0.41,111,271,0.41,0,0,0.0,23,0.078
eng,340,304,5.7,53.333,102,266,0.383,102,266,0.383,0,0,0.0,38,0.125
eng,302,619,9.019,68.63,214,577,0.371,214,577,0.371,0,0,0.0,42,0.068
eng,335,505,5.567,90.719,184,482,0.382,184,482,0.382,0,0,0.0,23,0.046
eng,307,199,3.25,61.229,71,197,0.36,71,197,0.36,0,0,0.0,2,0.01
eng,320,166,3.612,45.954,60,160,0.375,60,160,0.375,0,0,0.0,6,0.036
eng,323,260,4.611,56.383,104,236,0.441,104,236,0.441,0,0,0.0,24,0.092
eng,330,269,3.932,68.414,111,262,0.424,111,262,0.424,0,0,0.0,7,0.026
eng,326,133,3.922,33.91,64,128,0.5,64,128,0.5,0,0,0.0,5,0.038
eng,336,171,4.683,36.512,68,156,0.436,68,156,0.436,0,0,0.0,15,0.088
eng,301,202,4.058,49.782,71,187,0.38,71,187,0.38,0,0,0.0,15,0.074
eng,314,225,4.809,46.791,81,209,0.388,81,209,0.388,0,0,0.0,16,0.071
eng,416,782,6.106,128.078,213,732,0.291,213,732,0.291,0,0,0.0,50,0.064
eng,424,1733,13.965,124.093,527,1661,0.317,527,1661,0.317,0,0,0.0,72,0.042
eng,422,432,4.004,107.891,165,419,0.394,165,419,0.394,0,0,0.0,13,0.03
eng,419,630,6.941,90.771,211,581,0.363,211,581,0.363,0,0,0.0,49,0.078
eng,418,403,2.438,165.304,134,347,0.386,134,347,0.386,0,0,0.0,56,0.139
eng,420,617,5.899,104.594,217,580,0.374,217,580,0.374,0,0,0.0,37,0.06
eng,425,445,3.932,113.183,150,411,0.365,150,411,0.365,0,0,0.0,34,0.076
eng,417,524,6.449,81.259,165,472,0.35,165,472,0.35,0,0,0.0,52,0.099
eng,414,661,5.185,127.484,229,642,0.357,229,642,0.357,0,0,0.0,19,0.029
eng,421,243,2.976,81.665,77,220,0.35,77,220,0.35,0,0,0.0,23,0.095
eng,418,340,3.396,100.132,131,319,0.411,131,319,0.411,0,0,0.0,21,0.062
eng,423,283,5.652,50.073,115,283,0.406,115,283,0.406,0,0,0.0,0,0.0
eng,504,368,3.624,101.546,111,342,0.325,111,342,0.325,0,0,0.0,26,0.071
spa,512,381,7.166,53.168,81,274,0.296,4,4,1.0,77,270,0.281,107,0.281
eng,518,569,6.183,92.022,191,510,0.375,191,510,0.375,0,0,0.0,59,0.104
spa,507,594,7.796,76.194,159,486,0.327,29,33,0.879,130,453,0.267,108,0.182
eng,511,404,5.4,74.815,139,366,0.38,139,366,0.38,0,0,0.0,38,0.094
eng,508,220,3.6,61.111,96,219,0.438,96,219,0.438,0,0,0.0,1,0.005
eng,514,238,3.767,63.186,57,199,0.286,57,199,0.286,0,0,0.0,39,0.164
spa,502,228,5.481,41.596,76,227,0.335,0,0,0,76,227,0.335,1,0.004
spa,517,546,7.964,68.555,128,391,0.327,11,11,1.0,117,380,0.299,155,0.284
eng,501,255,3.628,70.29,95,233,0.408,95,233,0.408,0,0,0.0,22,0.086
spa,504,466,6.001,77.652,128,448,0.286,0,0,0,128,448,0.286,18,0.039
spa,508,263,4.794,54.865,72,205,0.351,7,15,0.467,65,190,0.317,58,0.221
spa,514,376,6.596,57.008,65,275,0.236,0,0,0,65,275,0.236,101,0.269
spa,501,207,3.29,62.918,91,204,0.446,0,0,0,91,204,0.446,3,0.014
eng,517,412,5.35,77.009,142,374,0.38,142,374,0.38,0,0,0.0,38,0.092
eng,512,326,4.155,78.454,120,309,0.388,120,309,0.388,0,0,0.0,17,0.052
spa,511,397,10.772,36.854,64,298,0.215,1,1,1.0,63,297,0.211,99,0.249
eng,507,643,6.25,102.88,194,584,0.332,194,584,0.332,0,0,0.0,59,0.092
spa,516,325,4.6,70.647,77,246,0.313,10,12,0.833,67,234,0.272,79,0.243
eng,515,587,4.133,142.016,145,500,0.29,145,500,0.29,0,0,0.0,87,0.148
spa,503,215,6.779,31.718,71,180,0.394,12,15,0.8,59,165,0.328,35,0.163
eng,509,259,4.0,64.75,83,237,0.35,83,237,0.35,0,0,0.0,22,0.085
eng,510,341,4.383,77.795,120,328,0.366,120,328,0.366,0,0,0.0,13,0.038
eng,505,232,2.058,112.723,71,205,0.346,71,205,0.346,0,0,0.0,27,0.116
spa,513,347,9.702,35.765,46,228,0.202,2,3,0.667,44,225,0.193,119,0.343
spa,510,478,5.771,82.834,129,401,0.322,1,1,1.0,128,400,0.319,77,0.161
spa,505,149,3.563,41.819,52,148,0.351,0,0,0,52,148,0.351,1,0.007
eng,513,241,5.117,47.101,76,202,0.376,76,202,0.376,0,0,0.0,39,0.162
eng,516,435,4.35,100.0,128,391,0.327,128,391,0.327,0,0,0.0,44,0.101
spa,515,373,6.516,57.241,126,304,0.414,82,146,0.562,44,158,0.145,69,0.185
spa,509,264,6.098,43.292,67,221,0.303,43,84,0.512,24,137,0.109,43,0.163
spa,613,232,2.264,102.47,89,225,0.396,0,0,0,89,225,0.396,7,0.03
spa,612,180,1.953,92.157,74,165,0.448,0,0,0,74,165,0.448,15,0.083
spa,619,299,3.187,93.826,100,266,0.376,0,0,0,100,266,0.376,33,0.11
spa,609,204,2.505,81.428,61,179,0.341,0,0,0,61,179,0.341,25,0.123
spa,602,184,2.258,81.475,74,180,0.411,0,0,0,74,180,0.411,4,0.022
spa,601,213,2.121,100.427,86,201,0.428,0,0,0,86,201,0.428,12,0.056
spa,610,355,4.528,78.404,125,338,0.37,0,0,0,125,338,0.37,17,0.048
eng,605,239,3.03,78.868,97,223,0.435,97,223,0.435,0,0,0.0,16,0.067
spa,611,252,2.107,119.621,95,237,0.401,1,1,1.0,94,236,0.397,15,0.06
spa,604,268,2.81,95.383,99,250,0.396,0,0,0,99,250,0.396,18,0.067
spa,505,204,2.277,89.601,87,204,0.426,0,0,0,87,204,0.426,0,0.0
spa,608,195,2.02,96.529,79,188,0.42,0,0,0,79,188,0.42,7,0.036
spa,618,223,2.317,96.257,94,221,0.425,0,0,0,94,221,0.425,2,0.009
spa,607,236,2.711,87.04,87,236,0.369,0,0,0,87,236,0.369,0,0.0
spa,622,272,3.034,89.649,92,256,0.359,0,0,0,92,256,0.359,16,0.059
spa,614,336,3.17,106.008,109,306,0.356,0,0,0,109,306,0.356,30,0.089
spa,615,217,3.464,62.651,76,203,0.374,0,0,0,76,203,0.374,14,0.065
spa,623,251,2.651,94.697,87,236,0.369,0,0,0,87,236,0.369,15,0.06
spa,617,309,2.977,103.807,116,290,0.4,0,0,0,116,290,0.4,19,0.061
spa,621,208,2.493,83.42,79,187,0.422,0,0,0,79,187,0.422,21,0.101
spa,620,236,2.92,80.815,63,199,0.317,0,0,0,63,199,0.317,37,0.157
spa,616,211,2.95,71.519,86,196,0.439,0,0,0,86,196,0.439,15,0.071
spa,726,226,2.459,91.901,90,217,0.415,0,0,0,90,217,0.415,9,0.04
spa,715,315,3.062,102.882,116,301,0.385,0,0,0,116,301,0.385,14,0.044
spa,701,335,4.822,69.478,139,332,0.419,0,0,0,139,332,0.419,3,0.009
spa,719,320,3.672,87.148,111,305,0.364,0,0,0,111,305,0.364,15,0.047
spa,717,372,4.951,75.135,167,372,0.449,0,0,0,167,372,0.449,0,0.0
spa,703,258,2.64,97.716,115,258,0.446,0,0,0,115,258,0.446,0,0.0
spa,706,428,4.141,103.364,159,416,0.382,0,0,0,159,416,0.382,12,0.028
spa,705,454,4.489,101.133,158,441,0.358,0,0,0,158,441,0.358,13,0.029
spa,711,487,5.722,85.117,169,449,0.376,0,0,0,169,449,0.376,38,0.078
spa,710,396,4.168,95.018,146,379,0.385,0,0,0,146,379,0.385,17,0.043
spa,704,236,3.26,72.397,96,234,0.41,0,0,0,96,234,0.41,2,0.008
spa,722,329,3.148,104.516,120,316,0.38,0,0,0,120,316,0.38,13,0.04
spa,725,371,4.67,79.439,131,343,0.382,0,0,0,131,343,0.382,28,0.075
spa,724,345,3.687,93.574,115,345,0.333,0,0,0,115,345,0.333,0,0.0
spa,721,331,2.822,117.28,130,324,0.401,0,0,0,130,324,0.401,7,0.021
spa,709,474,5.596,84.699,145,442,0.328,0,0,0,145,442,0.328,32,0.068
spa,708,203,3.004,67.581,82,198,0.414,0,0,0,82,198,0.414,5,0.025
spa,720,249,3.276,76.012,106,243,0.436,0,0,0,106,243,0.436,6,0.024
spa,718,381,3.468,109.872,139,376,0.37,0,0,0,139,376,0.37,5,0.013
spa,723,255,2.14,119.152,121,251,0.482,0,0,0,121,251,0.482,4,0.016
